##　基本的に初出の作品での不確定名ですが、一部他との統一のため変えてあります。
##　不確定名みただけでわかるのはマイルフィック御大だけで十分だぃ(笑)
##　（や、ボスクラスには他にも一発でバレる奴居ますが）
##　五十音順

ＷＩＺサムライ	鎧を着た男
ＷＩＺシーフ	ローブを着た男
ＷＩＺニンジャ	ローブを着た男
ＷＩＺビショップ	鎧を着た男
ＷＩＺファイター	鎧を着た男
ＷＩＺプリースト	鎧を着た男
ＷＩＺメイジ	ローブを着た男
ＷＩＺロード	鎧を着た男

アークエンジェル	まばゆい姿
アークデーモン	火のような姿
アーマーイーター	奇妙な動物
アイアンゴーレム	ゴーレム
アガレス	悪魔
アンデッドコボルド	骸骨
イビル・アイ	灼熱の球体
インキュバス	悪魔
ヴィーナスマントラップ	奇妙な植物
ウィル・オー・ウィスプ	正体不明の存在
エアジャイアント	巨人
エンジェル	まばゆい姿
オーク	人間型の生き物
オークロード	オーク
オロチ	ドラゴン

カーディナルファング	ローブを着た男
ガスドラゴン	ドラゴン
風の王デジン	風の王デジン
グウィリオン	奇妙な少女
クリーピングコイン？	小さな物体
グレーターデーモン	悪魔
ゲイズハウンド	奇妙な動物
氷の王ロブナ	氷の王ロブナ
コボルド	人間型の生き物

サイデル	髑髏
サキュバス	悪魔
サンドクラッド	這いずるもの
シャセツ	うずくまる人影
スクライル	髑髏
スケイリーエンプレス	ドラゴン
ストーンゴーレム	ゴーレム
スモッグビースト	正体不明の存在
ゼノ	どろどろした物
ソードマン	鎧を着た男
ゾンビ	不気味な生き物

ティエンルン	ドラゴン
ディスプレッサービースト	奇妙な動物
ディスペラント	恐怖を呼び起こすもの
デーモンロード	悪魔
デス	骸骨
デルフ	生ける伝説
デルフズミニオン	やつれた姿
トーガ・ラマ	ローブを着た動物
トライアス	あらぶる姿
ドラゴネア	ドラゴン
ドラゴンゾンビ	ドラゴン
ドラゴンパピー	けだもの
ドラゴンフライ	蝿

ノーシーアム	昆虫
信長	鎧を着た男

ハークルビースト	ハークルビースト
バブリースライム	スライム
バンシー	正体不明の存在
バンパイア	やつれた姿
バンパイアロード	やつれた姿
ヒムズ	悪魔
火の王カンジ	火の王カンジ
火の女王ザナ	火の女王ザナ
ビューティ＆ビースト	ビューティ＆ビースト
ファイアージャイアント	巨人
ファイアドラゴン	ドラゴン
ファズボール	ふわふわしたもの
フライプリミアー	巨大な蝿
フラック	奇妙な動物
ブラックドラゴン	ドラゴン
プリーステス	鎧を着た女
ブリーブ	奇妙な動物
フロストジャイアント	巨人
ヘルハウンド	犬
ヘルマスター	悪魔
ポイズンジャイアント	巨人
ボーパルバニー	ウサギ
ボーリングビートル	昆虫
ポレ	骸骨のような姿

マーフィーズゴースト	正体不明の存在
マイルフィック	正体不明の魔物
マジックアーマー	命を吹き込まれた物体
マジックガントレット	命を吹き込まれた物体
マジックシールド	命を吹き込まれた物体
マジックソード	命を吹き込まれた物体
マジックヘルメット	命を吹き込まれた物体
ミーミアー	巨人
ミフネ	鎧を着た男
モートモンスター	巨大な蛇

ライカーガス	骸骨のような姿
ララ＝ムームー	ララ＝ムームー
蘭丸	ローブを着た男
レイバーロード	鎧を着た男
レッサーデーモン	悪魔
ロッティングコープス	不気味な生き物

ワーアメーバ	原生生物
