共通
パルセイバー		昆虫の精を浴び不思議な力を持った短剣
インプットマグナム	多機能ガンでキーを押し分け、ビームを使い分ける
ソニックフラップ	アーマー同士を共振させて放つ波動
パルスラッシュ		パルセイバーに超エネルギーを発生させ切る
セイバーマグナム	セイバーとマグナムがエネルギーを増幅し合う強力なビーム
マキシムビーム		フルパワーで撃つセイバーマグナム

ブルービート
ビートルパンチ		パンチ
ビートルキック		右足のひねりを利かせた回転キック
スティンガーブレード	ダイヤの１０倍の堅さを持つ剣
スティンガードリル	プラズマを吹き出し威力を増すドリル
ビートルブレイク	刃を高速回転させエネルギーを吹き出しその力で敵を袈裟懸けにする
ストライクブラスト	ドリルを高速回転させプラズマを吹き出しながら相手に突き刺す
ビートイングラム	異次元世界の武器で真の勇者のみが使える
スーパーファイナルブローイングラムにセイバーのエネルギーを加えた最強のビーム

ジースタッグ
ジーパンチ		ジャンプしてのパンチが多い
ジーキック		ジャンプキックが得意で、片足と両足を使い分ける
ハリケーンスイング	敵の足を持って振り回す
スティンガークロー	ハサミで敵を締め付ける武器
ジークラッシュ		クローを素早く敵に突き刺す…後の先属性がつけたい…
ジーアタック		ジャンプして敵を突く反撃技
ジーリフター		クローで締め付け敵を持ち上げる
スティンガーブーメラン	クローを飛ばして敵を撃つ
レイジングスラッシュ	エネルギーを集め敵を一機に切り裂く

レッドル
レッドポイントパンチ	敵の弱点を見極めた正確なスピードパンチ
クイックキック		猛スピードのキック、特に回転キックが強力
レッドアタック		スピードをいかした体当たり
スティンガープラズマー	強力なプラズマを放つことができる
レッドハング		プラズマで敵を持ち上げ捕まえる
トルネードスパーク	エミッターから強力なエネルギービームを放つ

シャドウ
ビートルパンチ		パンチ(適当な名前がないのでブルービートと同じにした)
ビートルキック		キック(同上)
ジャミングマグナム	インプットマグナムと同性能の銃
スティンガービュート	長さ１００ｍのワイヤーと１ｍの剣の二つのモードがある
